***X***
XX*X*X*
***X*X*
*XXX*X*
***X*X*
XX*XXX*
*******